1 1 1 1 1 1 1 1 1 1 1 1 1 1 1 1 1 1 1 1 1 1 1 1 1 1 1 1 1 1 1 1 1 1 1 1 1 1 1 1 1 1 1 1 1 1 1 1 1 1 1 1 1 1 1 1 1
1 1 1 1 1 1 1 1 1007 1007 1007 1007 1007 1007 1007 1007 1007 1007 1007 1007 1007 1007 1007 1007 1007 1007 1007 1007 1007 1007 1007 1007 1007 1007 1007 1007 1007 1007 1007 1007 1007 1007 1007 1007 1007 1007 1007 1007 1007 1007 1007 1007 1007 1007 1007 1 1
1 1 1 1 1 1206 0 0 0 0 0 3101 3102 0 0 0 0 0 0 0 0 0 3101 3102 0 0 0 0 3101 3102 0 0 0 0 0 0 0 0 0 0 0 3101 3102 0 0 0 0 0 0 0 3101 3102 0 0 0 3805 1
1 1 1 1 1 1206 0 0 0 0 0 0 0 0 0 0 0 0 0 0 0 0 0 0 0 0 0 0 0 0 0 0 0 0 0 0 0 0 0 0 0 0 0 0 0 0 0 0 0 0 0 0 0 0 0 3805 1
1 1 1 1 1 1206 0 0 0 0 0 0 0 0 0 0 0 0 0 0 0 0 0 0 0 0 0 0 0 0 0 0 0 0 0 0 0 0 0 0 0 0 0 0 0 0 0 0 0 0 0 0 0 0 0 3805 1
1 1 1 1 1 1 0 0 121 122 5301 5302 141 142 143 5301 5302 151 152 5301 5302 161 162 163 5301 5302 171 172 5301 5302 181 182 183 5301 5302 191 192 5301 5302 201 202 203 5301 5302 211 212 5301 5302 221 222 5301 5302 0 236 237 3805 1
1 1 1 1 1 0 0 0 123 124 3805 1506 144 145 146 1505 4106 153 154 4105 1606 164 165 166 1605 1606 173 174 5305 5306 184 185 186 4005 4006 193 194 1705 1706 204 205 206 1705 1806 213 214 1805 3906 223 224 3905 1806 3105 238 239 3805 1
1 1 1 1 1 0 0 0 0 0 3805 1506 0 0 0 1505 4106 0 0 4105 1606 0 0 0 1605 1606 0 0 5305 5306 0 0 0 4005 4006 0 0 1705 1706 0 0 0 1705 1806 0 0 1805 3906 0 0 3905 1806 3106 0 0 3805 1
1 1 1 1 1 0 0 0 0 0 3805 1506 0 0 3107 1505 4106 0 3107 4105 1606 0 0 0 1605 1606 0 0 5305 5306 0 0 0 4005 4006 0 0 1705 1706 0 0 3107 1705 1806 3105 0 1805 3906 3105 0 3905 1806 0 0 0 3805 1
1 1 1 1 1 1 0 0 0 0 3805 1506 0 0 3108 1505 4106 0 3108 4105 1606 0 0 0 1605 1606 0 0 5305 5306 0 0 3107 4005 4006 0 0 1705 1706 0 0 3108 1705 1806 3106 0 1805 3906 3106 0 3905 1806 1 0 0 3805 1
1 1 1 1 1 4206 0 0 0 0 3805 1506 0 0 0 1505 4106 0 0 4105 1606 0 0 0 1605 1606 0 0 5305 5306 0 0 3108 4005 4006 0 0 1705 1706 0 0 0 1705 1806 0 0 1805 3906 0 0 3905 1806 0 0 0 3805 1
1 1 1 1 1 4206 0 0 0 0 3805 1506 0 0 0 1505 4106 0 0 4105 1606 0 0 0 1605 1606 0 0 5305 5306 0 0 0 4005 4006 0 0 1705 1706 0 0 0 1705 1806 0 0 1805 3906 0 0 3905 1806 0 0 0 3805 1
1 1 1 1 1 4206 0 0 0 0 3805 1506 0 0 0 1505 4106 0 0 4105 1606 0 0 0 1605 1606 0 0 5305 5306 0 0 0 4005 4006 0 0 1705 1706 0 0 0 1705 1806 0 0 1805 3906 0 0 3905 1806 0 0 0 3805 1
1 1 1 1 1 4206 3105 0 0 3107 3805 1506 0 0 0 1505 4106 0 0 4105 1606 0 0 3107 1605 1606 0 0 5305 5306 0 0 0 4005 4006 0 0 1705 1706 0 0 0 1705 1806 0 3107 1805 3906 0 3107 3905 1806 0 0 0 3805 1
1 1 1 1 1 4206 3106 0 0 3108 3805 1506 0 0 0 1505 4106 0 0 4105 1606 0 0 3108 1605 1606 0 0 5305 5306 0 0 0 4005 4006 0 0 1705 1706 0 0 0 1705 1806 0 3108 1805 3906 0 3108 3905 1806 0 0 0 3805 1
1 1 1 1 1 4206 0 0 0 0 3805 1506 0 0 0 1505 4106 0 0 4105 1606 0 0 0 1605 1606 0 0 5305 5306 0 0 0 4005 4006 0 0 1705 1706 0 0 0 1705 1806 0 0 1805 3906 0 0 3905 1806 0 0 0 3805 1
1 1 1 1 1 4206 0 0 0 0 3805 1506 0 0 0 1505 4106 0 0 4105 1606 0 0 0 1605 1606 0 0 5305 5306 0 0 0 4005 4006 0 0 1705 1706 0 0 0 1705 1806 0 0 1805 3906 0 0 3905 1806 0 0 0 3805 1
1 1 1 1 1 4206 3105 0 0 0 3805 1506 0 0 0 1505 4106 0 0 4105 1606 0 0 0 1605 1606 0 0 5305 5306 0 0 3107 4005 4006 0 3107 1705 1706 0 0 0 1705 1806 0 0 1805 3906 0 0 3905 1806 3105 0 0 3805 1
1 1 1 1 1 4206 3106 0 0 0 3805 1506 0 0 0 1505 4106 0 0 4105 1606 0 0 0 1605 1606 0 0 5305 5306 0 0 3108 4005 4006 0 3108 1705 1706 0 0 0 1705 1806 0 0 1805 3906 0 0 3905 1806 3106 0 0 3805 1
1 1 1 1 1 4206 0 0 0 0 3805 1506 3105 0 0 1505 4106 3105 0 4105 1606 0 0 0 1605 1606 0 0 5305 5306 0 0 0 4005 4006 0 0 1705 1706 3105 0 0 1705 1806 3105 0 1805 3906 3105 0 3905 1806 1 0 0 3805 1
1 1 1 1 1 4206 0 0 0 0 3805 1506 3106 0 0 1505 4106 3106 0 4105 1606 0 0 0 1605 1606 0 0 5305 5306 0 0 0 4005 4006 0 0 1705 1706 3106 0 0 1705 1806 3106 0 1805 3906 3106 0 3905 1806 0 0 0 3805 1
1 1 1 1 1 4206 0 0 0 0 3805 1506 0 0 0 1505 4106 0 0 4105 1606 0 0 0 1605 1606 0 0 5305 5306 0 0 0 4005 4006 0 0 1705 1706 0 0 0 1705 1806 0 0 1805 3906 0 0 3905 1806 0 0 0 3805 1
1 1 1 1 1 4206 3105 0 121 122 3805 1506 141 142 143 1505 4106 151 152 4105 1606 161 162 163 1605 1606 171 172 5305 5306 181 182 183 4005 4006 191 192 1705 1706 201 202 203 1705 1806 211 212 1805 3906 221 222 3905 1806 230 231 232 3805 1
1 1 1 1 1 4206 3106 0 123 124 5304 5303 144 145 146 5304 5303 153 154 5304 5303 164 165 166 5304 5303 173 174 5304 5303 184 185 186 5304 5303 193 194 5304 5303 204 205 206 5304 5303 213 214 5304 5303 223 224 5304 5303 233 234 235 2005 1
1 1 1 1 1 4206 0 0 0 0 0 0 0 0 0 0 0 0 0 0 0 0 0 0 0 0 0 0 0 0 0 0 0 0 0 0 0 0 0 0 0 0 0 0 0 0 0 0 0 0 0 0 0 0 0 2005 1
1 1 1 1 1 4206 0 0 0 0 5301 5302 0 0 0 5301 5302 0 0 5301 5308 5302 0 0 0 0 0 0 5301 5308 5308 5302 0 5301 5308 5308 5302 0 5301 5302 0 0 5301 5302 0 0 5301 5308 5302 0 0 5301 5302 0 0 2005 1
1 1 1 1 1 4306 0 0 0 0 5304 5303 0 0 0 5304 5303 0 0 5304 5307 5303 0 0 5304 5303 0 0 5304 5307 5307 5303 0 5304 5307 5307 5303 0 5304 5303 0 0 5304 5303 0 0 5304 5307 5303 0 0 5304 5303 0 0 2005 1
1 1 1 1 1 4306 0 0 0 0 0 0 0 0 0 0 0 0 0 0 0 0 0 0 0 0 0 0 0 0 0 0 0 0 0 0 0 0 0 0 0 0 0 0 0 0 0 0 0 0 0 0 0 0 0 2005 1
1 1 1 1 1 4306 0 0 101 102 5301 5302 0 91 0 5301 5302 81 82 5301 5302 0 71 0 5301 5302 61 62 5301 5302 0 51 0 5301 5302 41 42 5301 5302 0 31 0 5301 5302 21 22 5301 5302 11 12 0 0 0 0 0 2005 1
1 1 1 1 1 4306 0 0 103 104 4305 4406 0 92 0 1305 4606 83 84 5105 4706 0 72 0 4705 2206 63 64 2205 4806 0 52 0 5205 4906 43 44 4905 5006 0 32 0 5005 1906 23 24 1905 2106 13 14 0 1 1 0 0 2005 1
1 1 1 1 1 4306 0 0 0 3107 4305 4406 0 0 3107 1305 4606 0 3107 5105 4706 0 0 3105 4705 2206 0 3107 2205 4806 3105 0 0 5205 4906 0 3107 4905 5006 0 0 3107 5005 1906 0 0 1905 2106 0 0 0 2105 2006 0 0 2005 1
1 1 1 1 1 4306 0 0 0 3108 4305 4406 0 0 3108 1305 4606 0 3108 5105 4706 0 0 3106 4705 2206 0 3108 2205 4806 3106 0 0 5205 4906 0 3108 4905 5006 0 0 3108 5005 1906 0 0 1905 2106 0 0 0 2105 2006 0 0 2005 1
1 1 1 1 1 4306 3105 0 0 0 4305 4406 0 0 0 1305 4606 0 0 5105 4706 0 0 0 4705 2206 0 0 2205 4806 0 0 0 5205 4906 0 0 4905 5006 0 0 0 5005 1906 0 0 1905 2106 0 0 0 2105 2006 0 0 2005 1
1 1 1 1 1 4306 3106 0 0 0 4305 4406 0 0 0 1305 4606 0 0 5105 4706 0 0 0 4705 2206 0 0 2205 4806 0 0 0 5205 4906 0 0 4905 5006 0 0 0 5005 1906 0 0 1905 2106 0 0 0 2105 2006 0 0 2005 1
1 1 1 1 1 4306 0 0 0 0 4305 4406 0 0 0 1305 4606 0 0 5105 4706 0 0 0 4705 2206 0 0 2205 4806 0 0 0 5205 4906 0 0 4905 5006 0 0 0 5005 1906 0 0 1905 2106 0 0 0 2105 2006 0 0 2005 1
1 1 1 1 1 4306 0 0 0 0 4305 4406 0 0 0 1305 4606 0 0 5105 4706 0 0 0 4705 2206 0 0 2205 4806 0 0 0 5205 4906 0 0 4905 5006 0 0 0 5005 1906 0 0 1905 2106 0 0 0 2105 2006 0 0 2005 1
1 1 1 1 1 4306 0 0 0 0 4305 4406 3105 0 0 1305 4606 0 0 5105 4706 0 0 0 4705 2206 0 0 2205 4806 0 0 3107 5205 4906 3105 0 4905 5006 0 0 0 5005 1906 3105 0 1905 2106 0 0 0 2105 2006 0 0 1 1
1 1 1 1 1 4306 0 0 0 0 4305 2306 3106 0 0 4505 4606 0 0 5105 4706 0 0 0 4705 2206 0 0 2205 4806 0 0 3108 5205 4906 3106 0 4905 5006 0 0 0 5005 1906 3106 0 1905 2106 0 0 0 2105 2006 0 0 0 1
1 1 1 1 1 4306 0 0 0 0 4305 2306 0 0 0 4505 4606 0 0 5105 4706 0 0 0 4705 2206 0 0 2205 4806 0 0 0 5205 4906 0 0 4905 5006 0 0 0 5005 1906 0 0 1905 2106 0 0 0 0 0 0 0 0 1
1 1 1 1 1 4306 0 0 0 0 4305 2306 0 0 0 4505 4606 0 0 5105 4706 0 0 0 4705 2206 0 0 2205 4806 0 0 0 5205 4906 0 0 4905 5006 0 0 0 5005 1906 0 0 1905 2106 0 0 0 1 1 0 0 1 1
1 1 1 1 1 4306 0 0 0 0 4305 2306 0 0 0 4505 4606 0 0 5105 4706 0 0 0 4705 2206 0 0 2205 4806 0 0 0 5205 4906 0 0 4905 5006 0 0 0 5005 1906 0 0 1905 2106 0 0 2101 2108 2102 0 0 3005 1
1 1 1 1 1 4306 0 0 0 0 4305 2306 0 0 0 4505 4606 0 0 5105 4706 0 0 0 4705 2206 0 0 2205 4806 0 0 0 5205 4906 0 0 4905 5006 0 0 0 5005 1906 0 0 1905 2106 0 0 2105 1 2106 0 0 3005 1
1 1 1 1 1 4306 0 0 0 3107 4305 2306 0 0 3107 4505 4606 3105 0 5105 4706 3105 0 0 4705 2206 3105 0 2205 4806 3105 0 0 5205 4906 0 3107 4905 5006 3105 0 0 5005 1906 0 0 1905 2106 0 0 2105 1 2106 0 0 3005 1
1 1 1 1 1 4306 0 0 0 3108 4305 2306 0 0 3108 4505 4606 3106 0 5105 4706 3106 0 0 4705 2206 3106 0 2205 4806 3106 0 0 5205 4906 0 3108 4905 5006 3106 0 0 5005 1906 0 0 1905 2106 0 0 2105 1 2106 0 0 3005 1
1 1 1 1 1 4306 0 0 101 102 4305 2306 0 91 0 4505 4606 81 82 5105 4706 0 71 0 4705 2206 61 62 2205 4806 0 51 0 5205 4906 41 42 4905 5006 0 31 0 5005 1906 21 22 1905 2106 11 12 2105 1 2106 0 0 3005 1
1 1 1 1 1 4306 0 0 103 104 5304 5303 0 92 0 5304 5303 83 84 5304 5303 0 72 0 5304 5303 63 64 5304 5303 0 52 0 5304 5303 43 44 5304 5303 0 32 0 5304 5303 23 24 5304 5303 13 14 2105 1 2106 0 0 3005 1
1 1 1 1 1 4306 0 0 0 0 0 0 0 0 0 0 0 0 0 0 0 0 0 0 0 0 0 0 0 0 0 0 0 0 0 0 0 0 0 0 0 0 0 0 0 0 0 0 0 0 2104 2107 2103 0 0 3005 1
1 1 1 1 1 4306 0 0 0 0 0 0 0 0 0 0 0 0 0 0 0 0 0 5301 5302 0 5301 5308 5308 5302 0 0 5301 5302 0 0 5301 5308 5302 0 0 0 0 0 0 0 0 0 0 0 0 0 0 0 0 3005 1
1 1 1 1 1 1 0 0 0 0 5301 5302 0 0 0 5301 5302 0 0 5301 5302 0 0 5304 5303 0 5304 5307 5307 5303 0 0 5304 5303 0 0 5304 5307 5303 0 0 0 5301 5302 0 0 5301 5302 0 5301 5308 5302 0 0 0 3005 1
1 1 1 1 1 1406 0 0 0 0 0 0 0 0 0 0 0 0 0 5304 5303 0 0 0 0 0 0 0 0 0 0 0 0 0 0 0 0 0 0 0 0 0 5304 5303 0 0 5304 5303 0 5304 5307 5303 0 0 0 3005 1
1 1 1 1 1 1406 0 0 0 0 5301 5302 0 0 0 0 0 0 0 0 0 0 0 0 0 0 0 0 0 0 0 0 0 0 0 0 0 0 0 0 0 0 0 0 0 0 0 0 0 0 0 0 0 0 0 3005 1
1 1 1 1 1 1406 0 0 0 0 3705 3706 0 0 5301 5302 0 0 5301 5302 0 0 0 0 0 0 0 0 0 0 0 0 2401 2408 2408 2408 2408 2408 2408 2402 0 0 0 0 0 0 0 0 0 0 0 0 0 0 0 3005 1
1 1 1 1 1 1406 0 0 0 0 3705 3706 0 0 3605 3606 0 0 3605 3606 0 0 0 2501 2508 2508 2508 2508 2502 0 0 0 2405 1 1 1 1 1 1 2406 0 0 0 1101 1108 1108 1108 1108 1108 1108 1108 1102 0 0 0 3005 1
1 1 1 1 1 1 1406 0 0 0 3705 3706 0 0 3605 3606 0 0 3605 3606 0 0 0 2505 1 1 1 1 2506 0 0 0 2405 1 1 1 1 1 1 2406 0 0 0 1104 1107 1107 1107 1107 1107 1107 1107 1103 0 0 0 3005 1
1 1 1 1 1 1 1406 0 0 0 3705 3706 0 0 3605 3606 0 0 3605 3606 0 0 0 2505 1 1 1 1 2506 0 0 0 2405 1 1 1 1 1 1 2406 0 0 0 0 0 0 0 0 0 0 0 0 0 0 0 3005 1
1 1 1 1 1 1 1406 0 0 0 3705 3706 0 0 3605 3606 0 0 3605 3606 0 0 0 2505 1 1 1 1 2506 0 0 0 2405 1 1 1 1 1 1 2406 0 0 0 0 0 0 0 0 0 0 0 0 0 0 0 3005 1
1 1 1 1 1 1 1406 0 0 0 3705 3706 0 0 3605 3606 0 0 3605 3606 0 0 0 2505 1 1 1 1 2506 0 0 0 2405 1 1 1 1 1 1 2406 0 0 0 0 2601 3408 3408 3408 3408 3408 3408 3408 3402 0 0 3005 1
1 1 1 1 1 1 1 1 0 0 3705 3706 0 0 3605 3606 0 0 3605 3606 0 0 0 2504 2507 2507 2507 2507 2503 0 0 0 2404 2407 2407 2407 2407 2407 2407 2403 0 0 0 0 2604 3407 3407 3407 3407 3407 3407 3407 3403 0 0 3005 1
1 1 1 1 1407 1407 1 1 0 0 5304 5303 0 0 5304 5303 0 0 5304 5303 0 0 0 0 0 0 0 0 0 0 0 0 0 0 0 0 0 0 0 0 0 0 0 0 0 0 0 0 0 0 0 0 0 0 0 3005 1
1 1 1407 1403 0 0 0 0 0 0 0 0 0 0 0 0 0 0 0 0 0 0 0 0 0 0 0 0 0 0 0 0 0 0 3103 3104 0 0 0 0 0 0 0 3401 3408 3408 3408 3408 3408 3408 3408 3402 0 0 0 3005 1
1 1406 0 0 0 0 0 0 0 0 0 0 0 0 1401 1402 0 1401 1408 1402 0 0 0 0 0 0 0 0 0 0 0 1801 1808 1808 1808 1808 1808 1808 1802 0 0 0 0 3204 3207 3207 3207 3307 3307 3307 3307 3303 0 0 0 3005 1
1 1 1402 0 0 0 1401 1408 1408 1408 1408 1402 0 0 1405 1406 0 1405 1 1406 0 0 0 0 0 0 0 0 0 0 0 1804 1807 1807 1807 1807 1807 1807 1803 0 0 0 0 0 0 0 0 0 0 0 0 0 0 0 0 3005 1
1 1 1406 0 0 0 1404 1407 1407 1407 1407 1403 0 1 1405 1406 0 1405 1 1406 0 0 0 2601 2608 2608 2608 2608 2602 0 0 0 0 0 3101 3102 0 0 0 0 0 0 0 0 0 0 0 0 0 0 0 0 0 0 0 3005 1
1 1 1406 0 0 0 0 0 0 0 0 0 0 1 1405 1406 0 1405 1 1406 0 0 0 2605 1 1 1 1 2606 0 0 0 0 0 0 0 0 0 0 0 0 0 0 0 0 0 0 0 0 0 0 0 0 0 0 3005 1
1 1 1406 0 0 0 0 0 0 0 0 0 0 0 1405 1406 0 1405 1 1406 0 0 0 2605 1 1 1 1 2606 0 0 0 2801 2808 2808 2808 2808 2808 2808 2802 0 0 0 2701 2708 2708 2708 2708 2708 2708 2708 2702 0 0 0 2905 1
1 1 1406 0 0 1401 1408 1408 1408 1408 1408 1402 0 0 1405 1406 0 1404 1407 1403 0 0 0 2605 1 1 1 1 2606 0 0 0 2805 1 1 1 1 1 1 2806 0 0 0 2705 1 1 1 1 1 1 1 2706 0 0 0 2905 1
1 1 1406 0 0 1404 1407 1407 1407 1407 1407 1403 0 0 1404 1403 0 0 0 0 0 0 0 2605 1 1 1 1 2606 0 0 0 2804 2807 2807 2807 2807 2807 2807 2803 0 0 0 2704 2707 2707 2707 2707 2707 2707 2707 2703 0 0 0 2905 1
1 1 1406 0 0 0 0 0 0 0 0 0 0 0 0 0 0 0 1401 1402 0 0 0 2604 2607 2607 2607 2607 2603 0 0 0 0 0 0 0 0 0 0 0 0 0 0 0 0 0 0 0 0 0 0 0 0 0 0 1509 1
1 1 1406 0 0 1401 1408 1408 1408 1408 1402 0 0 0 0 0 0 0 1404 1403 0 0 0 0 0 0 0 0 0 0 0 0 0 0 0 0 0 0 0 0 0 0 0 0 0 0 0 0 0 0 0 0 0 0 0 1509 1
1 1 1 1402 0 1404 1407 1407 1407 1407 1403 0 0 0 1401 1402 0 0 0 0 0 0 0 0 0 0 0 0 0 0 0 0 0 0 0 0 0 0 0 0 0 0 0 0 0 0 0 0 0 0 0 0 0 0 0 1509 1
1 1 1 1406 0 0 0 0 0 0 0 0 0 0 1404 1403 0 0 1401 3508 3508 3508 3508 3508 3502 0 0 0 0 0 0 0 0 0 0 0 0 0 0 0 0 0 0 0 0 0 0 0 0 0 0 0 0 0 0 1 1
1 1 1 1406 0 0 0 0 0 0 0 0 0 0 1 1 0 0 1405 1 1 1 1 1 1 1 5407 242 3701 3702 242 3701 3702 242 3701 3702 242 3701 3708 3702 0 0 0 3701 3702 242 3701 3702 242 3701 3702 242 5406 1 1 1 1
1 1 1 1406 0 1401 1408 1408 1408 1408 1402 0 0 0 0 0 0 0 1405 1 1 1 1 1 1 1 5407 243 3705 3706 243 3705 3706 243 3705 3706 243 3705 1 3706 0 0 0 3705 3706 243 3705 3706 243 3705 3706 243 5406 1 1 1 1
1 1 1 1406 0 1404 1407 1407 1407 1407 1403 0 0 0 0 0 0 0 1405 1 1 1 1 1 1 1 5407 244 3705 3706 244 3705 3706 244 3705 3706 244 3705 1 3706 0 0 0 3705 3706 244 3705 3706 244 3705 3706 244 5406 1 1 1 1
1 1 1 1406 0 0 0 0 0 0 0 0 1401 1408 1408 1408 1402 0 1405 1 1 1 1 1 1 1 5407 245 5501 5502 245 5501 5502 245 5501 5502 245 5501 5502 3706 0 0 0 3705 5407 245 5501 5502 245 5501 5502 245 5501 5502 1 1 1
1 1 1 1 1402 0 0 0 0 1401 1408 1408 1 1 1 1 1406 0 1405 1 1 1 1 1 1 1 5407 246 5527 5528 246 5523 5524 246 5519 5520 246 5515 5516 3706 0 0 0 3705 5407 246 5511 5512 246 5507 5508 246 5503 5504 1 1 1
1 1 1 1 1406 0 0 1401 1408 1 1 1 1 1 1 1 1 1 1 1 1 1 1 1 1 1 5407 247 5529 5530 247 5525 5526 247 5521 5522 247 5517 5518 3706 257 257 257 3705 5407 247 5513 5514 247 5509 5510 247 5505 5506 1 1 1
1 1 1 1 1 1 1408 1 1 1 1 1 1 1 1 1 1 1 1 1 1 1 1 1 1 1 1 1 1 1 1 1 1 1 1 1 1 1 1 1 1 1 1 1 1 1 1 1 1 1 1 1 1 1 1 1 1
1 1 1 1 1 1 1 1 1 1 1 1 1 1 1 1 1 1 1 1 1 1 1 1 1 1 1 1 1 1 1 1 1 1 1 1 1 1 1 1 1 1 1 1 1 1 1 1 1 1 1 1 1 1 1 1 1